1 1 1 1 1 1
1 1 1 1 1 1
1 0 0 0 0 1
1 0 0 0 0 1
1 0 0 0 0 1
5 5 5 5 0 1
5 5 5 5 0 1
5 0 0 0 0 1
5 0 0 0 0 1
5 0 3 3 3 3
5 0 3 3 3 3
5 0 0 0 0 3
5 0 0 0 0 3
4 4 4 4 0 3
4 4 4 4 0 3
0 0 0 0 0 3
0 0 0 0 0 3
0 0 2 2 2 2

